--------
-#####--
-#...#--
-#.+.#
-#...#
-#...#
-#2.2#
-#...###
-#.....#
-#.?.?<#
-#.?.?>#
##.....#
#.?.####
#......#
#<><?<>######
#>?><><#??@?#
#<><>?>#?l>l#
#><><><#..<.#
###..###....#
-#.....#.???#
-#..>..#....3
-#.l.l.#....7
-1.....#....3
-#.l.l.#....7
-1.....#....3
-#.....#..??#
-##.......??#
--#...#######
--######-----
-------------