--------------
#??llllllllll#
#?@..........3
#l...........7
#llllllllll..#
#2?6?2?6?2l.?#
#llllllllll..#
#...........?#
#l.llllllllll#
#l...........#
#llll??lllll>#
#........?...7
#......?.....3
#><llllllllll#
#<>??44#######
#.??##########
1...........+#
##?#?#?#?#?#?#
--------------